10 10
4 3 // Сначала спуск по y затем сдвиг по x rob4 rob2
##########
#    E   #
#  ####  #
#    #  ##
#      # #
#    #  ##
#      # #
#  #  #  #
#     E  #
##########