10 10
7 1 // Сначала спуск по y затем сдвиг по x rob3 rob1 rob4
##########
# E      #
#  ####  #
#  #  #  #
#  #  #  #
#  #  #  #
#  #  #  #
#  #  #  #
#   E E  #
##########